{
  "version": 1,
  "name": "demo_level",
  "enemies": [[5, 3]],
  "grid": [
    [1,1,1,1,1,1,1,1,1,1,1,1],
    [1,2,0,0,0,0,0,0,0,0,3,1],
    [1,0,1,1,0,1,1,1,0,1,0,1],
    [1,0,0,0,0,0,0,1,0,0,0,1],
    [1,0,1,0,1,1,0,0,0,1,0,1],
    [1,1,1,1,1,1,1,1,1,1,1,1]
  ]
}